sgRNA	gene
ATAACGACAAAGACCGAGAA	Hqmyazd5
TCTTATGCTACAGTATACAA	Drwoqbf0
GTCATAATGTACCTGTACTA	Otjwkad
CTGGATCACCGGCGATGTCG	Hqmyazd5
CCGGCGATGTGGCGTCTGTG	Hqmyazd5
CCACCTCATAGACAATGTAG	Mbafz6
CAGATGTGTTCGCAGAAGGT	Mbafz6
CCAACGAAGTGGTTACCTTG	Hcbp
TTGACATAGCCGTAATACGG	Otjwkad
GGATTCATACGACGTGACTG	Drwoqbf0
TGATGGGTCCATGATAACCG	Mbafz6
GATGTACATCGGCTGAGTGA	Otjwkad
CCGGATCCCATGGTCAACCA	Drwoqbf0
AAGGAGCCAACATAACAGAT	Hcbp
GCAAAGAGTCACCTAAAGTT	Hqmyazd5
GGACTCAGTGATCAAACCCC	Otjwkad
TAGAGCGGGTCATGAATCAC	Hqmyazd5
GCCAAGAAAGGATCTTGTAG	Hcbp
CACATCCCTGACCCAACCTG	Otjwkad
GCGACACGCGCAGTTTGTGG	Hcbp
TGCGACCGCAACCTGGCCAT	Hcbp
TTGGCAGATAAACCCAACAG	Otjwkad
